.........##################
###.############.........##
###.####.#######.#######.##
###.####.#######.#######.##
....####.#######.#######.##
.#######.#######.#######.##
.................#######.##
#########.###########......
#########.####.######.#####
#######........######......
